NO ./assets/player.xpm
SO ./assets/player.xpm
WE ./assets/player.xpm
EA ./assets/player.xpm
F 220,100,8
C 225,30,0
111111111
110001001
10000101
110N01111
11111111
